1111111111111111111111111
1C000001C000C0000100000C1
1000001C1C000000111000C01
1P0001CCC1C000000C0C00001
10001CCCC1C0010000CC00001
1000000000C0011000CCCC001
1C00C00000000000C000CCE01
1111111111111111111111111